####################################################################################################################################################
#                          #        #                    #                       #              #  #              #     #              #        #  #
#######  #  #############  #  ####  #  #  #  ##########  ####  ################  #  ##########  #  #  #######  #  #  #  #  ##########  #  ####  #  #
#     #  #        #        #     #     #  #  #        #        #        #     #  #  #        #     #  #  #     #     #  #     #        #     #  #  #
#  #  #######  #  #############  #######  ####  ####  #  #######  ####  #  #  #  #  #######  ####  #  #  #  ##########  ####  ####  #######  #  #  #
#  #        #  #           #     #     #        #  #  #  #        #  #  #  #     #  #     #  #     #  #  #     #     #     #     #           #  #  #
#  ####B##  #  ##########  #  #######  ##########  #  ####  #######  #  #######  #  #  #  #  #  ####  #  ####  #  #  ####  ####  #############  #  #
#     #     #  #           #  #                    #     #  #        #        #     #  #  #        #        #     #     #        #     #        #  #
####  #  #######  ##########  #  #  #############  ####  #  #  ####  #######  #######  #  ################  ##########  ##########  #  #  #######  #
#     #           #           #  #              #     #  #  #  #     #     #           #  #     #           #     #     #     #     #  #     #     #
#  #############  #  ##########  #############  #######  #  #  #  ####  ################  #  #  #  ##########  #  #  #######  #  #  #  ####  ####  #
#  #              #  #     #     #        #     #        #  #  #     #        #        #     #     #        #  #     #        #  #  #     #     #  #
#  #  #############  #  #  #  ####  ####  #  #  #  #######  #  ####  ####  #  #  #  ################  ####  #  ##########  #  #  #  ##########  #  #
#  #        #        #  #           #     #  #  #  #           #           #  #  #           #  #     #     #  #           #  #  #           #     #
#  #######  #  ############################  ####  #  ######################  ##########  #  #  #  ####  ####  #  #############  ##########  ####  #
#  #     #  #  #    A                        #     #     #  #     #        #           #  #     #     #        #        #        #        #     #  #
#  #  #  ####  #  #########################  #  #  ####  #  #  #  #  #  #############  #  ##########  #############  #  #  #######  #######  #  #  #
#     #     #  #        #     #     #        #  #     #  #  #  #  #  #                 #  #        #              #  #     #     #     #     #  #  #
#  #######  #  #  ####  #  ####  #  #  #######  ####  #  #  #  #  ####  ################  #  ####  #  ##########  #  ##########  #  #  #  #  ####  #
#  #     #     #  #  #  #        #     #     #     #  #     #  #     #                    #  #     #        #     #  #        #     #  #  #  #     #
#  ####  #######  #  #  #  ################  ####  #######  #  ####  ##########  ##########  #  #############  ####  ####  #  ####  #  #  #  #  ####
#        #           #  #     #              #  #        #  #  #  #     #        #           #        #     #  #  #  #     #     #  #  #  #  #  #  #
#######  ####  #######  ####  #  #######  #  #  ####  #  #  #  #  ####  ####  ####  ################  #  #  #  #  #  #  #######  ####  #  #  #  #  #
#     #     #  #     #     #  #     #     #     #  #  #  #  #  #     #     #  #  #              #  #     #  #  #        #  #           #  #  #     #
#  #  ####  ####  #  ####  #  #######  #######  #  #  ####  #  #  #######  #  #  #############  #  #######  #  ##########  #  ##########  #######  #
#  #     #        #        #           #     #     #        #  #        #  #     #           #  #     #     #        #     #  #           #     #  #
#  #  ##################################  #  ####  ##########  #  #  ####  #######  #######  #  #  #  #  ####  ####  #  ####  #  ####  ####  #  #  #
#  #                             #        #        #     #     #  #           #     #     #  #  #  #     #     #     #  #     #  #     #     #  #  #
#  ####  ##########  #############  ################  #  #  ################  #  ####  #  #  #  #  #######  ####  ####  #  ####  #  ####  ####  #  #
#  #     #        #  #              #              #  #  #                 #     #  #  #     #  #     #  #  #     #  #        #  #  #  #     #  #  #
#  #  #  #  ####  #  #  #############  ##########  #  #  ################  #######  #  #######  ####  #  #  #  ####  #  #######  #  #  ####  #  #  #
#  #  #  #     #  #  #  #     #        #              #  #              #     #        #        #  #  #     #  #        #  #     #     #     #     #
####  #######  #  ####  #  #  #  #  #  ################  #  #  #######  ####  #  #############  #  #  #######  ####  ####  #  ##########  ##########
#     #        #  #     #  #  #  #  #  #           #  #  #  #  #     #  #     #                 #  #        #     #        #  #           #     #  #
#  ####  #######  #  ####  #  ####  #  #  #######  #  #  ####  #  #  #  #  #  ###################  #######  ####  #######  #  #  ##########  #  #  #
#        #        #        #  #     #  #     #     #  #  #     #  #     #  #  #           #     #           #     #        #  #  #           #     #
#  #######  ####  ##########  #  #######  ####  ####  #  #  ##########  #  ####  #######  #  #  #  ##########  #############  #  ##########  ####  #
#  #     #  #  #  #        #  #           #     #           #        #  #        #     #     #  #              #              #           #     #  #
####  #  #  #  #  #  #  #  #  #  ##########  #######  #######  ####  #############  #  #######  ####  #############  ###################  ####  #  #
#     #     #     #  #  #  #  #  #  #     #        #  #        #  #                 #     #     #  #  #     #     #  #        #        #  #     #  #
#  ##########  ####  #  ####  #  #  #  #  #######  ####  #######  ################  #  #  #  ####  #  #  #  #  #  #  #  ####  #  ####  #  #  ####  #
#     #           #  #     #  #     #  #        #  #     #              #        #  #  #  #     #     #  #  #  #     #  #     #  #     #  #     #  #
#  #  ##########  #  ####  #  #######  #######  #  #  #######  #######  #  ####  ####  #######  #######  #  #  ####  #  #  ####  #  ####  #  #  ####
#  #           #  #  #     #           #  #     #           #     #     #  #           #        #        #  #     #  #  #        #     #  #  #     #
#  ##########  ####  #  #  #############  #  #############  ####  ####  #  #######  ####  ####  #  #######  ####  #  #  #############  #  #  ####  #
#  #        #        #  #                 #              #     #     #  #        #  #     #  #  #  #     #     #  #  #  #           #     #     #  #
#  #  ####  ##########  ##########  ###################  ####  ####  #  #######  ####  ####  #  #  #  #  ####  #  ####  #######  #  ##########  #  #
#  #     #     #     #     #        #              #     #           #  #     #     #  #  #     #     #  #  #  #     #  #     #  #     #        #  #
#  ####  ####  ####  ####  ##########  ####  ####  #  ###################  #  ####  #  #  #  ##########  #  #  ####  #  #  #  ####  #  #  #######  #
#  #     #  #  #        #  #           #     #     #              #        #        #  #        #  #     #  #     #        #  #     #  #  #        #
#  #  ####  #  #  ####  #  #  ##########  ####  ################  #  #############  #  #######  #  #  ####  ####  ##########  #  #######  #  ####  #
#     #        #  #     #     #  #     #     #           #     #     #  #     #     #        #  #  #     #     #        #     #           #  #     #
#######  #######  ####  #######  #  #  ####  #######  ####  #  #######  #  #  #  ##########  #  #  ####  ####  #######  ####  #############  #  ####
#     #     #        #  #     #     #     #  #     #  #     #  #        #  #           #     #     #                 #     #     #        #  #     #
#  #######  ####  #  #  #  #  #  ####  #  #  #  #  ####  ####  #  ####  #  #############  ##########  ###################  ####  #  ####  #  ####  #
#        #     #  #  #  #  #  #  #     #  #     #           #  #     #     #     #        #        #     #              #     #     #        #     #
#  #  #  ####  ####  #  #  #  #  #  ####  ###################  ####  #######  #  #  ####  #  ####  #  ####  ##########  ####  ##########  ##########
#  #  #  #     #     #     #  #  #     #        #     #           #     #     #  #     #  #  #     #  #     #                 #        #  #        #
####  #  #  ####  ##########  #  ####  ####  ####  #  #  #############  #  ####  ####  #  #  #  #  #  #  ######################  ####  ####  ####  #
#     #  #  #     #        #  #  #  #  #     #     #  #        #        #     #        #  #  #  #  #  #                          #  #           #  #
#  ####  #  #  ####  #  ####  #  #  #  #  ####  ####  #######  #  ##########  ##########  #  #  ####  ############################  #############  #
#     #  #     #  #  #        #     #  #  #     #     #     #        #        #           #  #  #                                #        #        #
#  #  ##########  #  #############  #  ####  ####  #  #  ##########  #  #######  ##########  #  #  ############################  #######  #  #######
#  #  #        #     #              #           #  #  #  #     #     #  #     #        #     #  #     #                    #              #        #
#  #  #  #  ####  ###############################  #  #  #  #  #######  #  ##########  #  ####  #  ####  ################  #############  #######  #
#  #     #        #                                #  #  #  #  #        #              #     #     #     #        #     #     #     #     #     #  #
#  ################  ###############################  #  #  #  #  #######  ################  #############  #######  #  ####  #  #  #  #######  #  #
#     #           #     #              #                 #  #     #              #        #        #  #        #     #     #     #  #  #        #  #
####  #  #######  ####  #  #  ##########  #######  #######  #######  #############  #  #  #######  #  #  ####  #  #######  #######  #  #  #  ####  #
#     #  #     #     #  #  #  #           #     #     #     #     #        #        #  #        #  #     #     #  #     #           #     #  #     #
#  ####  #  #  ####  #  #  #  #  ##########  #  #######  #  #  #  ####  ####  #######  #######  #  ####  #  #  #  ####  ###################  #  ####
#  #        #  #     #  #  #  #     #  #     #           #  #  #     #  #     #     #     #  #  #     #  #  #  #     #              #        #     #
#  ##########  #  ####  #  #######  #  #  ##########  #######  ####  ####  ####  #  ####  #  #  ####  #  #  #######  #######  #  ####  ##########  #
#  #           #        #              #  #           #        #  #  #     #     #  #     #        #  #  #        #        #  #  #     #     #     #
#  #  ###################  #############  ##########  #  #######  #  #  #######  #  #  ####  #######  #######  #  #######  #  ####  ####  ####  #  #
#  #  #                 #     #           #        #  #     #     #  #           #  #  #  #     #     #        #        #  #              #     #  #
#  #  ####  #  #############  #  #######  #  ####  #######  #  ####  ##########  ####  #  #  ####  ####  #############  #  ################  ####  #
#  #  #     #  #           #  #  #        #  #  #  #     #  #     #        #     #     #     #     #        #           #                 #  #  #  #
#  #  #  #######  #######  #  #  ##########  #  #  #  #  #  ####  #  #######  ####  ##########  ##########  #  #########################  #  #  #  #
#     #                 #     #                 #     #           #              #                          #                          #     #     #
####################################################################################################################################################
