######################################################################
#     #                    #                       #     #           #
####  #  #  #############  #  ###################  #  #  #######  ####
#     #  #              #     #  #     #           #  #  #     #     #
#  ####  #############  #######  #  #  #  ##########  #  #  #  ####  #
#     #     #  #     #        #  #  #  #  #           #     #  #     #
####  ####  #  #  #  #######  #  #  #  #  #  ################  #  ####
#     #        #  #     #     #     #  #  #  #  #              #     #
#  ####  #######  ####  #  #######  #  #  #  #  #  #############  #  #
#        #     #     #  #        #  #     #  #     #     #        #  #
##########  #  ####  #  #######  #############  ####  #  #######  #  #
#        B  #        #           #           #  #     #        #  #  #
#  ################  #############  #######  #  ####  #######  ####  #
#              #     #     #     #  #     #  #        #     #        #
#  ##########  #######  #  #  #  #  ####  #  ##########  #  #######  #
#     #     #     #     #     #  #        #  #        #  #        #  #
####  #  #######  #  #######  #  #######  #  #  #  ####  #######  #  #
#  #     #     #     #     #  #        #  #  #  #  #     #     #  #  #
#  ####  #  #  #######  #  ####  #######  #  #  #  #  ####  #  #  #  #
#     #  A  #     #     #        #        #     #     #     #  #     #
####  #  #  ####  #  #############  #########################  #######
#     #  #     #     #        #     #        #              #        #
#  ####  ####  #######  ####  #  ##########  #  ####  ####  ####  ####
#     #     #              #  #  #     #     #  #  #  #  #     #     #
####  ####  ################  #  #  #  #  ####  #  #  #  ####  ####  #
#     #     #     #           #     #  #        #  #  #     #     #  #
#  ####  #######  #  #######  #######  #  #######  #  #  #  ####  #  #
#     #  #        #  #              #  #  #     #  #  #  #     #     #
#  #  #  #  #######  #  #############  #  #  #  #  #  #######  ####  #
#  #        #        #     #        #  #     #     #     #        #  #
#############  ####  #######  ####  #  #  #############  #  #######  #
#              #     #     #     #  #  #  #              #  #        #
#  #######  ##########  #  ####  #  #  ####  #############  #  #######
#     #     #           #     #  #  #  #     #        #  #     #     #
#  #  #######  #############  #  #  #  #  #######  #  #  #  ####  #  #
#  #           #        #     #  #  #  #  #        #     #  #     #  #
#  ###################  #  ####  #  #  #  ####  #######  #  #######  #
#  #                    #        #  #  #  #     #     #  #  #        #
#  #  #  #########################  #  #  #  #######  #  #  #  ####  #
#  #  #        #        #     #     #     #        #     #     #  #  #
#  #  #######  #  ####  #  #  #  ##########  ####  #############  #  #
#  #        #  #  #        #     #        #     #                    #
#  #  #######  #  #  #######  ####  #  #######  ######################
#  #  #        #  #  #     #  #     #           #     #     #        #
#  ####  ####  #  ####  #  ####  ################  #  #  #  ####  #  #
#        #     #        #                          #     #        #  #
######################################################################
