##########################################################
#                       #              #        #     #  #
#  ########A#B########  #  ####  ####  #  ####  #  #  #  #
#        #        #     #     #  #        #        #     #
#######  #######  #  #######  #  #########################
#  #     #        #        #  #  #                       #
#  #  ####  #  #######  ####  #  #  ######################
#     #     #  #        #     #     #        #        #  #
#  #######  #  #  #######  #############  #  #  ####  #  #
#           #  #                          #     #        #
##########################################################
