################################################################
#                 #  #                             #           #
#  #############  B  #  #  ######################  #  #  #######
#        #  #        #  #     #        #           #  #        #
#  ####  #  #  #######  ####  #  ####  #######  ####  #######  #
#  #  #  #        #     #  #     #  #        #  #           #  #
#  #  #  #  #######  ####  #######  #######  ####  ##########  #
#     #  #  #        #     #           #     #        #     #  #
#######  #  #  #######  #  #######  #  #  ####  #######  #  #  #
#        #  #        #  #           #  #     #  #  #     #     #
#  ################  #  ####  #############  #  #  #  #######  #
#        #           #  #     #           #        #     #  #  #
#  ####  #  ##########  #  ####  #######  #############  #  #  #
#  #  #     #           #  #     #     #     #     #     #  #  #
#  #  ##########  ##########  #######  ####  #  #  #  ####  #  #
#  #          A   #                 #     #  #  #  #     #  #  #
#  ##########  #  #  #############  #  ####  #  #  ####  #  #  #
#     #     #  #  #     #     #        #     #  #     #  #     #
####  #  #  #  #######  #  #  #######  #  #  #  ####  #  ####  #
#     #  #  #           #  #        #  #  #  #     #  #     #  #
#  ####  #  #############  #######  ####  #######  #  #  #  ####
#  #     #  #              #     #     #        #  #  #  #     #
#  #  ####  #  #############  #######  ####  ####  #  #  ####  #
#  #  #     #  #     #        #     #        #     #  #  #     #
#  #  ####  #  #  ####  ####  #  #  #######  #  ####  ####  #  #
#  #     #     #        #     #  #           #     #        #  #
#  #  #  #######  #######  #  #  ################  #  ##########
#  #  #     #  #  #     #  #  #                 #  #  #        #
#  #######  #  #  #  #  #  ###################  #  ####  ####  #
#  #        #     #  #  #  #           #        #           #  #
#  #  #######  ####  #  #  #  #######  #  ###################  #
#     #     #  #     #  #        #  #                    #     #
#######  ####  #  #############  #  ################  ####  #  #
#     #     #     #        #           #           #  #     #  #
#  ####  #  ####  #  ####  #############  #######  ####  #######
#  #     #        #  #  #           #     #     #     #        #
#  #  #############  #  ##########  #  #######  ####  #######  #
#  #     #     #     #           #     #           #        #  #
#  ####  ####  #  ##########  #  #######  #######  #######  #  #
#     #  #     #  #        #  #  #        #     #        #  #  #
#  ####  #  #  #  #  ####  #  #  #  #  ####  ##########  #  #  #
#  #     #  #  #  #  #     #  #  #  #     #  #           #     #
#  #  ####  #  #  #  #  ####  #  #  ####  #  #  #############  #
#     #     #  #     #  #  #  #  #  #  #  #  #     #        #  #
#  #######  ##########  #  #  #  #  #  #  #  ####  ####  #  #  #
#        #  #           #     #        #  #     #  #     #  #  #
#######  #  #  #  #######  #############  #  ####  #  #  ####  #
#     #     #  #  #     #     #     #     #           #  #     #
#  #  ####  #  ####  #  #######  #  #  ###################  ####
#  #        #  #     #        #  #     #        #        #  #  #
#  ##########  #  ##########  #  #######  ####  #  ####  #  #  #
#  #     #     #  #        #  #              #  #     #  #  #  #
#  #  #  #  ####  ####  ####  #############  #  ####  #  #  #  #
#     #  #              #     #        #     #     #  #  #  #  #
#  ################  ####  #  #  ####  #  #######  #  #  #  #  #
#  #           #     #     #  #  #     #  #     #     #     #  #
#  #  #######  #######  #  ####  #  ####  ####  #############  #
#  #  #     #     #     #  #     #     #     #        #     #  #
####  #  #######  #  ####  #  #######  ####  #  ####  #  #  #  #
#     #              #     #        #     #  #  #        #     #
#  ####  ##########  #############  ####  #  #  ################
#  #     #     #     #              #  #  #     #              #
#  #  ####  #  #######  #############  #  #  ####  ##########  #
#  #  #     #     #     #  #           #  #  #     #           #
#  ####  #######  #  ####  #  #######  #  ####  ####  ##########
#     #  #     #     #        #     #  #     #  #     #        #
#  #  #  ####  #############  #  #  #  ####  #  #  ####  ####  #
#  #  #     #              #  #  #        #  #  #        #  #  #
####  ####  ####  #######  #  #  ##########  #  ##########  #  #
#        #     #     #     #  #  #     #     #     #        #  #
#  ##########  #  #  #  #######  #  #  #  #  #######  ####  #  #
#           #  #  #  #           #  #  #  #  #        #     #  #
#######  #  #  ####  ##########  #  #  #  #  #  #  #  #######  #
#     #  #  #  #     #     #     #  #  #  #  #  #  #  #        #
#  #  ####  #  #  ####  #  #######  #  #  #  #  #  #  #  #######
#  #        #     #     #           #     #  #  #  #  #        #
#  #############  #  #############  ##########  #  ##########  #
#  #           #  #  #        #     #           #  #        #  #
#  #  #######  #  #  #  ####  #######  ##########  #  #  ####  #
#           #     #  #  #  #        #        #  #     #        #
##########  #######  #  #  #######  #######  #  ################
#     #        #     #     #     #        #        #        #  #
#  #  #  #######  #  ####  #  #  #  #############  ####  #  #  #
#  #  #     #     #     #  #  #  #              #  #     #     #
#  #  #######  ##########  #  ##########  #######  #  #######  #
#  #     #     #           #        #  #  #     #     #     #  #
#  ####  #  #  #  ##########  #  #  #  #  #  #  #######  #  #  #
#     #     #  #        #  #  #  #  #  #     #     #     #  #  #
#  #  ####  ##########  #  #  #  #  #  #######  #  #  #  ####  #
#  #     #  #           #     #  #     #  #     #  #  #        #
#  ####  #  #  ################  ####  #  #  #######  ##########
#  #     #  #  #                 #  #     #           #        #
#  #  ####  #  #######  ##########  ####  ################  #  #
#  #  #     #        #  #           #     #                 #  #
####  #############  #  #  #######  #  ################  ####  #
#     #     #        #  #        #  #           #     #  #  #  #
#  ####  #  #  #######  #  ####  #############  #  #  #  #  #  #
#        #              #     #                    #     #     #
################################################################
