#####################################################################################################################################
#                 #                 #                    #     #              #           #  #        #        #           #        #
#######  #######  ##########  ####  #  ####  ##########  ####  #  #  #######  #  #  ####  #  #  #  #  #  #######  #  ####  #  ####  #
#        #                 #     #  #     #     #     #     #     #  #        #  #  #  #  #     #  #  #           #  #  #     #  #  #
#  ####### B#############  #######  ####  ####  #  #  ####  #######  ##########  #  #  #  #######  #  #  ##########  #  #######  #  #
#  #              #     #        #           #     #  #  #           #           #  #  #        #  #  #     #     #  #  #        #  #
#  ####  #######  #  #  #######  ##########  #######  #  ##########  #  ##########  #  #######  #  #  #######  #  #  #  #  #  ####  #
#     #  #     #  #  #     #  #     #     #  #     #  #        #     #  #     #  #  #  #     #     #           #     #     #        #
#  #  ####  #  #  #  ####  #  ####  #  #  ####  #  #  #  #  #  #  ####  #  #  #  #  #  #  #  #########################  #############
#  #     #  #  #  #  #     #     #     #        #     #  #  #  #  #     #  #  #  #  #     #                       #     #     #     #
#  ####  #  #  ####  #  #######  #########################  ####  #  ####  #  #  #  #  #######  ###################  #######  #  #  #
#     #  #  #  #     #  #     #           #           #     #     #  #     #     #  #  #     #  #                 #  #        #  #  #
####  #  #  #  #  ####  #  #  ####  #  ####  #  ####  #  #  #  ####  #  #  #######  #  #  #  #  #  #############  #  #  #######  #  #
#  #  #     #     #  #     #  #     #  #     #     #     #  #     #  #  #        #  #  #  #  #     #     #  #     #  #  #        #  #
#  #  ##########  #  #######  #  #  ####  #######  #############  #  ####  ####  #  #  #  #  #######  #  #  #  ####  #  #  #######  #
#     #        #     #        #  #  #     #     #     #        #  #     #     #  #  #  #  #           #  #  #           #        #  #
#  ####  ####  ####  #  #######  ####  ####  #######  #  #  ####  ####  ####  #  #  #  ####  ##########  #  ###################  #  #
#  #     #  #  #     #  #              #           #     #           #     #  #  #  #        #        #              #           #  #
#  #  ####  #  #######  #  ##########  #######  #########################  ####  #  ##########  ####  #############  #  ##########  #
#  #  #     #  #     #  #     #     #        #        #     #  #        #  #     #              #  #           #     #  #        #  #
A  #  ####  #  #  #  #  #  ####  #  #######  ####  #  #  #  #  #  ####  #  #  #  ################  ##########  #  ####  #  ####  #  #
#  #     #        #     #  #     #        #        #     #  #  #  #  #  #  #  #                 #        #     #     #     #     #  #
#  ####  ###################  ##########  ################  #  #  #  #  #  #  ################  #######  #  ################  ####  #
#  #  #           #        #        #  #        #     #     #  #     #     #     #        #  #        #  #        #              #  #
#  #  ##########  #  ####  #######  #  #######  #  ####  ####  ####  ##########  #  ####  #  #######  #  #######  #  #############  #
#  #           #     #  #        #  #        #  #     #  #        #  #           #     #           #        #  #     #     #        #
#  ####  ####  #######  #######  #  #######  #  #  #  #  ####  #  #  #  #############  ####  #############  #  #######  #  #  ####  #
#     #  #  #  #  #           #  #  #        #  #  #  #     #  #  #  #  #           #  #     #           #     #        #     #     #
####  #  #  #  #  #  ####  ####  #  #  ####  #  #  #  ####  #  #  #  #  #  #  ####  #  #  ####  #######  ####  #  ###################
#  #     #  #  #        #     #  #     #  #  #  #  #           #  #     #  #  #  #  #  #  #     #     #        #  #                 #
#  #######  #  #######  ####  #  #######  #  #  ################  ##########  #  #  #  #  #  #######  ##########  #  #############  #
#           #        #  #     #           #  #              #     #        #  #  #  #  #  #        #     #        #           #  #  #
#  ####  ##########  #  #  #############  #  #############  #  ####  #  #  #  #  #  #  ##########  #  ####  ####  ##########  #  #  #
#     #  #        #  #  #     #           #  #        #     #  #     #  #  #  #     #           #  #  #     #     #        #  #     #
####  #  #  #  ####  #######  #  ####  ####  #  ####  #  #######  ####  #  #  #  ##########  #  #  #  #  ####  ####  ####  #  #  ####
#  #  #     #     #  #        #  #     #     #  #     #              #  #  #  #  #        #  #  #     #  #     #     #  #     #     #
#  #  ##########  #  #  ####  #  ####  #  ####  #  ###################  #  #  #  #  ####  #  #  ####  #  ####  #######  ##########  #
#  #  #        #  #  #  #     #     #  #  #     #     #        #        #     #     #        #     #  #     #     #     #     #     #
#  #  #  #  #  #  #  #  ####  ####  ####  #  #######  #  ####  #  #############  ###################  ####  ####  #  #  ####  #  ####
#     #  #  #  #     #     #  #     #     #  #     #     #     #     #           #              #     #  #  #        #        #     #
#  ####  #  #############  #  #  #  #  ####  #  #  ################  #  ##########  ##########  #  ####  #  #######  #############  #
#  #  #  #                 #  #  #  #  #     #  #  #        #        #           #        #     #  #     #     #     #        #     #
#  #  #  #############  ####  #  #  #  #  #  #  #  #  ####  #  ################  #######  #  ####  #  #######  #######  ####  #  ####
#  #  #     #        #  #     #  #  #  #  #  #  #  #  #     #        #  #     #  #     #  #        #        #     #     #  #     #  #
#  #  ####  #  #  ####  #  ####  ####  #  ####  #  #  #  ##########  #  #  #  #  ####  #  ################  ####  #  ####  #######  #
#  #           #  #     #  #  #     #  #     #  #  #  #  #           #     #  #  #     #  #           #     #  #     #        #     #
#  #############  #  ####  #  ####  #  ####  #  #  #  #  #  ##########  ####  #  #  ####  #  #######  #  #  #  #######  ####  #  #  #
#              #  #  #  #     #     #        #  #     #     #        #     #     #  #     #     #     #  #              #  #  #  #  #
#############  #  #  #  #  ####  ##########  #  #############  ##########  #######  #  #######  #  ####  ################  #  #  #  #
#        #     #  #  #  #  #     #           #              #                    #  #  #        #  #              #     #     #  #  #
#  ####  #  #######  #  #  #  #  #  ######################  ####  #############  #  #  #  #######  #  ##########  #  #  #  ####  #  #
#  #  #     #        #     #  #  #  #                 #  #     #  #     #     #     #  #     #     #           #     #  #     #  #  #
#  #  #######  #######  ####  ####  #  ##########  #  #  ####  ####  #  #  ####  ####  #  #  #  ######################  ####  #  #  #
#  #           #  #     #  #        #        #     #  #     #     #  #  #        #     #  #  #     #        #     #     #  #  #  #  #
#  ####  #######  #  ####  ###################  ####  ####  ####  #  #  ####  ####  #######  ####  #  ####  #  #  #  ####  #  ####  #
#        #     #     #     #                 #     #           #     #     #     #     #     #        #        #     #     #        #
##########  #  #  ####  ####  ####  #######  ####  ##########  ##########  ####  ####  #  ####  ######################  #  #######  #
#     #     #  #     #           #  #              #        #  #  #     #  #        #  #  #     #        #              #        #  #
#  ####  #  #######  #  ##########  ################  ####  #  #  #  #  #  #######  #  #  #######  ####  #  ####  ################  #
#  #     #        #  #  #     #     #        #        #  #  #  #     #  #  #     #  #  #  #     #  #  #  #     #        #     #     #
#  #  #######  #  #  ####  #  #  #  #  ####  #  #######  #  #  #######  #  #  #  ####  #  #  #  #  #  #  ####  #######  #  #  #  ####
#  #     #  #  #  #     #  #  #  #  #  #  #     #        #  #           #     #        #     #        #  #        #     #  #     #  #
#  ####  #  #  #######  #  #  #  ####  #  #######  #######  ##########  ################  ##########  #  ##########  ####  #######  #
#        #  #        #     #  #     #  #     #     #        #        #     #           #     #     #  #           #              #  #
#  #######  ####  ##########  ####  #  #  #  ####  #  #############  #  ####  ####  #######  #  #  #######  ####  #############  #  #
#        #     #           #     #  #     #     #  #        #     #     #        #        #  #  #        #     #        #     #  #  #
#######  ####  #######  #######  #  #  #######  #  #######  #  #  #  ####  #############  #  #  #######  ####  #######  ####  #  #  #
#     #     #        #           #  #  #     #        #  #     #  #  #  #  #  #           #  #     #  #  #     #     #  #     #  #  #
####  ####  #  ####  #############  #  #  #  #######  #  #######  #  #  #  #  #  #######  #  ####  #  #  #######  #  #  #  ####  #  #
#        #  #     #                    #  #  #        #        #  #  #  #     #  #     #  #  #  #  #  #  #        #  #  #  #     #  #
#  ####  #  ####  #######  #############  #  #  #######  #  ####  #  #  ####  #  #  #  ####  #  #  #  #  #  #######  #  #  #  ####  #
#     #  #     #  #     #        #        #  #  #        #  #     #     #     #     #        #  #  #        #           #  #     #  #
#  #  #######  #  #  #  #  #######  #######  #  ##########  #  #  #######  ###################  #  ##########  ##########  ####  #  #
#  #           #  #  #  #  #        #     #  #              #  #  #        #                    #        #        #     #           #
#  ################  #  ####  #######  ####  #############  #  ####  ######################  #  #######  #  #######  #  ##########  #
#  #                 #        #     #        #           #  #              #                 #     #  #  #  #        #           #  #
#  #######  ######################  #  #######  #######  #  #############  #  ###################  #  #  ####  ################  #  #
#  #        #  #                 #  #     #        #     #     #     #        #           #           #     #  #        #        #  #
#  #  #######  #  #  ##########  #  ####  #######  #  ##########  #  #  #############  ####  #############  #  #######  #  #######  #
#     #  #        #  #           #     #     #     #     #        #  #  #     #     #        #           #              #  #        #
#######  #  #######  #######  ####  #  ####  #  #######  #  #######  ####  #  #  #  #######  #  #######  ##########  ####  #  #######
#        #  #     #        #     #  #     #     #     #  #  #     #     #  #  #  #        #  #  #     #        #     #     #  #     #
#  ####  #  #  #  #######  ####  #  #############  ####  #  ####  ####  #  #  #  #######  #  #  ####  #######  #######  ####  #  #  #
#     #        #  #     #  #  #  #                 #     #     #        #  #     #        #  #  #     #     #        #     #  #  #  #
####  #############  #  #  #  #  #######  #######  #  ####  #  #######  #  #######  ##########  #  ####  #  #######  #  #  #  ####  #
#  #     #  #        #  #  #              #     #  #     #  #        #  #  #     #        #     #     #  #  #        #  #  #  #     #
#  ####  #  #  #######  #  ################  ####  ####  ##########  #  #  ####  #######  #  ####  #  #  #  #  ##########  #  #  ####
#     #  #  #     #        #        #     #           #        #     #     #     #        #  #  #  #     #  #  #           #  #     #
#  #  #  #  ####  #######  #  ####  #  #  ###################  #  ##########  #  #  #######  #  #  #######  #  #  ##########  #  #  #
#  #     #     #        #  #  #  #  #  #  #     #           #  #        #     #  #  #        #  #  #  #     #  #  #        #  #  #  #
#  ##########  #######  ####  #  #  #  #  #  #  #  #  #######  #######  #  #  ####  #  #######  #  #  #  ####  #  #  #  ####  ####  #
#                    #           #     #     #     #                    #  #           #              #           #  #              #
#####################################################################################################################################
