########################################################################################################################################
#              # A         #  #              #        #           #           #        #                 #     #                       #
#  #  ##########  ####  #  #  #  #  #######  #  #  ####  #  #######  #  ####  #  #  ####  #######  ####  ####  #  ####  #############  #
#  #           #     #  #     #  #        #     #  #     #           #     #     #  #     #     #  #           #  #  #  #        #     #
#  ##########  ####  B  ####  #  #######  #######  #  ###################  #  #######  ####  #  #  #############  #  #  #######  #  ####
#  #     #  #     #  #     #  #        #     #     #        #              #  #     #  #     #  #     #     #     #  #  #        #     #
#  #  #  #  ####  #  ####  ##########  ####  #######  #######  ####  ##########  #  #  #######  ####  #  #  #  ####  #  #  ##########  #
#     #     #     #  #     #           #  #           #     #  #     #     #     #                 #  #  #     #     #  #  #        #  #
##########  #  ####  #  #  #  ##########  #############  #  #  #  ####  #  #  ###################  #  #  #######  ####  #  #  ####  #  #
#     #  #  #        #  #  #     #        #           #  #     #  #     #     #     #           #  #  #     #     #     #     #  #  #  #
#  #  #  #  ##########  #######  #  ####  #######  #  #  #######  #  ##########  #  #  ####  ####  #  ####  ####  #  ####  ####  #  #  #
#  #     #  #        #        #  #     #        #  #  #     #     #     #     #  #  #     #        #              #  #  #        #     #
#  #######  #  ####  ####  #  #  #  #  #######  ####  ####  ##########  #  ####  #  #  #######  #######  ##########  #  #######  #######
#     #     #  #        #  #  #  #  #  #     #           #              #  #     #  #  #     #  #     #  #           #     #  #  #     #
####  #  #######  #######  ####  ####  #  #  ##########  ################  #  ####  ####  #  #  #  #  ####  ##########  #  #  #  ####  #
#     #        #  #     #  #     #     #  #  #           #                 #     #     #  #  #  #  #        #     #     #     #     #  #
#  ##########  #  #  #  #  #  ####  ####  ####  #############  #######  ####  #  ####  #  #  ####  ##########  #  #  #  ####  ####  #  #
#              #     #  #  #        #  #        #           #        #  #  #  #  #        #  #     #           #  #  #  #        #     #
#  ###################  #  ##########  #  #######  ####  #  #######  ####  #  #  ##########  #  ####  #  ##########  #  #############  #
#     #           #     #  #           #  #        #     #  #     #     #  #  #     #        #  #     #  #        #  #              #  #
####  #  #######  #  #  #  #  #  #######  ##########  ####  #  #  ####  #  #######  #  #######  #  #  ####  ####  #  ##########  ####  #
#        #           #  #     #                       #        #        #           #           #  #           #              #        #
########################################################################################################################################
